NO ./res/grass.xpm
SO ./res/wall.xpm
WE ./res/wood.xpm
EA ./res/brick.xpm

S0 ./res/hero.xpm
S1 ./res/0hero.xpm
S2 ./res/1hero.xpm
S3 ./res/hero.xpm
S4 ./res/hero.xpm
S5 ./res/hero.xpm
S6 ./res/hero.xpm
S7 ./res/hero.xpm

D ./res/sprite.xpm

F 255,255,255
C 100,100,100

11111111111111
10001000000001
10000001111101
10000100100001
10000D01100001
10000100101101
10000D01107101
10000100101101
10000D01100001
10000100100001
10000201111101
10000100000001
10000001166661
100N01005000011111111
100000011100067006601
100001001111111600601
100000011000011660601
100001001000011000001
100000011000011066661
100001001000011000001
111101011111311666601
110001003000030000001
100001011111311111111
11011101110001
10010101010001
10010000010001
10010001011111
1000010001
1000000011
102000001
140000001
120000001
111111111
